{
  "PacDotValue":10,
  "FruitValue":100,
  "PowerTime":5,
  "GameSpeed":250, // temps entre les mouvements
  "board":[
    [1,1,1,1,1,1,1,1,1,1,1,1,1,1,1,1,1,1,1],
    [1,2,2,2,2,2,2,2,2,1,2,2,2,2,2,2,2,2,1],
    [1,4,1,1,2,1,1,1,2,1,2,1,1,1,2,1,1,4,1],
    [1,2,2,2,2,2,2,2,2,2,2,2,2,2,2,2,2,2,1],
    [1,2,1,1,2,1,2,1,1,1,1,1,2,1,2,1,1,2,1],
    [1,2,2,2,2,1,2,2,2,1,2,2,2,1,2,2,2,2,1],
    [1,1,1,1,2,1,1,1,0,1,0,1,1,1,2,1,1,1,1],
    [1,1,1,1,2,1,3,0,0,5,0,0,3,1,2,1,1,1,1],
    [1,1,1,1,2,1,0,1,1,0,1,1,0,1,2,1,1,1,1],
    [0,0,0,0,2,0,0,1,5,5,5,1,0,0,2,0,0,0,0],
    [1,1,1,1,2,1,0,1,1,1,1,1,0,1,2,1,1,1,1],
    [1,1,1,1,2,1,3,0,0,0,0,0,3,1,2,1,1,1,1],
    [1,1,1,1,2,1,0,1,1,1,1,1,0,1,2,1,1,1,1],
    [1,2,2,2,2,2,2,2,2,1,2,2,2,2,2,2,2,2,1],
    [1,2,1,1,2,1,1,1,2,1,2,1,1,1,2,1,1,2,1],
    [1,4,2,1,2,2,2,2,2,6,2,2,2,2,2,1,2,4,1],
    [1,1,2,1,2,1,2,1,1,1,1,1,2,1,2,1,2,1,1],
    [1,2,2,2,2,1,2,2,2,1,2,2,2,1,2,2,2,2,1],
    [1,2,1,1,1,1,1,1,2,1,2,1,1,1,1,1,1,2,1],
    [1,2,2,2,2,2,2,2,2,2,2,2,2,2,2,2,2,2,1],
    [1,1,1,1,1,1,1,1,1,1,1,1,1,1,1,1,1,1,1]
  ],
  "startPacManX":9,
  "startPacManY":15,
  "startGhostX":9,
  "startGhostY":9
}